%%%%%%%%%%%%%%%%%%%%
%o...%........%....%
%.%%.%.%%%%%%.%.%%.%
%.%..............%.%
%.%.%%.%%  %%.%%.%.%
%......%G  G%......%
%.%.%%.%%%%%%.%%.%.%
%.%.....bOb......%.%
%.%%.%.%%%%%%.%.%%.%
%....%   P    %...o%
%%%%%%%%%%%%%%%%%%%%
